233 233 233 233 233 233 233 233 233 233 233 233 233 233 233 233 233 39 39 233 233 233 233 233 233 233 233 233 233 233 233 233 233 233 233 233 233 233 233 233 233 233 233
233 39 39 39 233 233 39 39 39 233 39 39 39 39 39 39 233 39 39 39 39 39 39 39 39 39 39 233 39 39 39 39 39 39 39 39 39 39 39 39 39 39 233
233 39 39 39 233 233 39 39 39 233 39 39 39 39 39 39 233 39 39 39 39 39 39 39 39 39 39 233 39 39 39 39 39 39 39 39 39 39 39 39 39 39 233
233 39 39 39 39 39 39 39 39 233 39 39 39 39 39 39 233 39 39 39 39 39 39 39 39 39 39 233 39 39 39 233 233 39 39 233 233 233 233 39 39 39 233
233 233 233 39 39 233 233 233 233 233 233 233 39 39 233 233 233 233 233 233 233 233 233 233 233 39 39 233 233 39 39 233 233 233 233 233 39 39 233 233 39 39 233
233 233 233 39 39 233 233 39 39 39 233 233 39 39 39 39 39 39 39 39 39 39 39 39 233 39 39 233 233 39 39 233 233 39 39 39 39 39 39 39 39 39 233
233 233 233 39 39 233 233 39 39 39 233 233 39 39 39 39 39 39 39 39 39 39 39 39 233 39 39 39 233 39 39 39 233 39 39 39 39 39 39 39 39 39 233
233 39 39 39 39 39 233 39 39 39 233 233 39 39 233 233 233 233 233 233 233 233 39 39 233 39 39 39 233 39 39 39 233 39 39 233 233 233 233 233 233 233 233
233 39 39 39 39 39 233 233 39 39 233 39 39 39 233 39 39 39 39 39 39 233 39 39 233 233 39 39 233 233 233 233 233 39 39 39 39 39 39 39 39 39 233
233 39 39 233 39 39 233 233 39 39 233 39 39 39 39 39 39 39 39 39 39 233 39 39 39 233 39 39 39 39 39 39 233 39 39 39 39 39 39 39 39 39 233
233 39 39 233 39 39 39 39 39 39 233 39 39 39 39 39 233 233 233 233 233 233 39 39 39 233 39 39 39 39 39 39 233 233 39 39 39 233 233 233 39 39 233
233 39 39 233 39 39 39 39 39 39 233 233 39 39 233 233 233 39 39 39 39 39 39 39 39 233 233 233 233 233 39 39 39 233 39 233 233 233 233 233 39 39 233
233 39 39 233 39 39 39 233 233 233 233 233 39 39 233 233 233 39 39 39 39 39 39 39 39 39 39 39 39 233 39 39 39 233 233 233 233 233 233 233 39 39 233
233 233 233 233 233 39 39 233 39 39 39 39 39 39 39 39 233 39 39 233 233 233 233 39 39 39 39 39 39 233 39 39 39 233 39 39 39 39 39 39 39 39 233
233 39 39 233 39 39 39 233 39 39 233 233 39 39 39 39 233 39 39 233 39 39 39 39 39 39 233 39 39 233 39 39 233 233 39 39 39 39 39 39 39 39 233
233 39 39 233 39 39 39 233 39 39 233 233 39 39 39 39 233 39 39 233 39 39 39 39 39 39 233 39 39 233 39 39 233 233 39 39 233 233 233 233 233 233 233
233 39 39 233 233 39 39 233 39 39 233 233 233 233 233 233 233 39 39 233 39 39 233 233 233 233 233 39 39 233 39 39 233 233 39 39 39 39 39 39 39 39 233
233 39 39 233 233 39 39 233 233 233 233 39 39 39 39 39 39 39 39 233 39 39 39 39 39 39 233 39 39 39 39 39 39 233 39 39 39 39 39 39 39 39 233
233 39 39 233 233 39 39 233 233 39 39 39 39 39 39 39 39 39 39 233 39 39 39 39 39 39 233 39 39 39 39 39 39 233 233 233 233 39 39 233 39 39 233
233 39 39 39 39 39 39 39 39 39 39 39 39 39 39 233 233 233 233 233 39 39 233 233 39 39 233 233 233 233 233 39 39 233 39 39 233 39 39 233 39 39 233
233 39 39 39 39 39 39 39 39 39 233 233 233 39 39 233 233 233 233 233 39 39 233 233 233 233 233 233 233 233 233 39 39 233 39 39 233 233 233 233 39 39 233
233 233 233 233 233 233 233 233 233 39 233 233 39 39 39 233 233 39 39 39 39 39 39 39 233 39 39 39 39 39 233 233 233 233 39 39 39 39 39 39 39 39 233
233 233 233 233 233 233 233 233 233 39 39 233 39 39 39 233 233 39 39 39 39 39 39 39 233 39 39 233 39 39 39 39 39 233 39 39 39 39 39 39 39 39 233
233 233 233 39 39 39 39 39 233 39 39 233 233 233 233 233 233 39 39 233 233 233 39 39 233 39 39 233 39 39 39 39 39 233 39 39 233 233 233 233 233 233 233
233 39 39 39 39 39 39 39 233 39 39 233 233 39 39 233 233 39 39 233 39 39 39 39 233 39 39 233 39 39 233 39 39 233 39 39 233 233 233 233 233 233 233
233 39 39 39 39 233 233 233 233 39 39 233 233 39 39 233 233 39 39 233 39 39 39 39 233 39 39 233 39 39 233 39 39 233 39 39 39 39 39 39 39 233 233
233 233 233 39 39 233 233 233 233 233 233 233 233 39 39 233 233 39 39 233 233 233 39 39 233 39 39 233 39 39 233 39 39 233 39 39 39 39 39 39 39 233 233
233 39 39 39 39 39 39 39 39 39 39 39 39 39 39 39 39 39 39 39 39 233 39 39 233 233 233 233 39 39 233 39 39 233 39 39 233 233 233 39 39 39 233
233 39 39 39 39 39 39 39 39 39 39 39 39 39 39 39 39 39 39 39 39 233 39 39 39 39 39 39 39 39 233 39 39 233 39 39 233 233 233 39 39 39 233
233 39 39 233 233 39 39 233 39 39 233 233 233 233 233 233 39 39 233 39 39 233 39 39 39 39 39 39 39 39 233 39 39 233 233 233 233 233 233 39 39 233 233
233 39 39 233 39 39 39 233 39 39 39 39 39 233 39 39 39 39 233 39 39 233 39 39 233 233 39 39 233 233 233 39 39 39 39 39 39 39 39 39 39 233 233
233 39 39 233 39 39 39 233 39 39 39 39 39 233 39 39 39 39 233 39 39 233 39 39 233 233 39 39 233 233 233 39 39 39 39 39 39 39 39 39 39 233 233
233 39 39 233 233 233 233 233 233 233 233 233 233 233 233 233 233 233 233 233 233 233 233 233 233 233 233 233 233 233 233 233 233 233 233 233 233 233 233 233 233 233 233
