39 39 39 39 39 39 39 39 39 39 39 39 39 39 39 39 39 39 39 39 39 39 39 39 39 39 39 39 39 39 39 39 39 39 39 39 39 39 39 39 39 39 39
39 129 129 129 39 39 129 129 129 39 129 129 129 129 129 129 39 129 129 129 129 129 129 129 129 129 129 39 129 129 129 129 129 129 129 129 129 129 129 129 129 129 39
39 129 129 129 39 39 129 129 129 39 129 129 129 129 129 129 39 129 129 129 129 129 129 129 129 129 129 39 129 129 129 129 129 129 129 129 129 129 129 129 129 129 39
39 129 129 129 129 129 129 129 129 39 129 129 129 129 129 129 39 129 129 129 129 129 129 129 129 129 129 39 129 129 129 39 39 129 129 39 39 39 39 129 129 129 39
39 39 39 129 129 39 39 39 39 39 39 39 129 129 39 39 39 39 39 39 39 39 39 39 39 129 129 39 39 129 129 39 39 39 39 39 129 129 39 39 129 129 39
39 39 39 129 129 39 39 129 129 129 39 39 129 129 129 129 129 129 129 129 129 129 129 129 39 129 129 39 39 129 129 39 39 129 129 129 129 129 129 129 129 129 39
39 39 39 129 129 39 39 129 129 129 39 39 129 129 129 129 129 129 129 129 129 129 129 129 39 129 129 129 39 129 129 129 39 129 129 129 129 129 129 129 129 129 39
39 129 129 129 129 129 39 129 129 129 39 39 129 129 39 39 39 39 39 39 39 39 129 129 39 129 129 129 39 129 129 129 39 129 129 39 39 39 39 39 39 39 39
39 129 129 129 129 129 39 39 129 129 39 129 129 129 39 129 129 129 129 129 129 39 129 129 39 39 129 129 39 39 39 39 39 129 129 129 129 129 129 129 129 129 39
39 129 129 39 129 129 39 39 129 129 39 129 129 129 129 129 129 129 129 129 129 39 129 129 129 39 129 129 129 129 129 129 39 129 129 129 129 129 129 129 129 129 39
39 129 129 39 129 129 129 129 129 129 39 129 129 129 129 129 39 39 39 39 39 39 129 129 129 39 129 129 129 129 129 129 39 39 129 129 129 39 39 39 129 129 39
39 129 129 39 129 129 129 129 129 129 39 39 129 129 39 39 39 129 129 129 129 129 129 129 129 39 39 39 39 39 129 129 129 39 129 129 39 39 39 39 129 129 39
39 129 129 39 129 129 129 39 39 39 39 39 129 129 39 39 39 129 129 129 129 129 129 129 129 129 129 129 129 39 129 129 129 39 39 39 39 39 39 39 129 129 39
39 39 39 39 39 129 129 39 129 129 129 129 129 129 129 129 39 129 129 39 39 39 39 129 129 129 129 129 129 39 129 129 129 39 129 129 129 129 129 129 129 129 39
39 129 129 39 129 129 129 39 129 129 39 39 129 129 129 129 39 129 129 39 129 129 129 129 129 129 39 129 129 39 129 129 39 39 129 129 129 129 129 129 129 129 39
39 129 129 39 129 129 129 39 129 129 39 39 129 129 129 129 39 129 129 39 129 129 129 129 129 129 39 129 129 39 129 129 39 39 129 129 39 39 39 39 39 39 39
39 129 129 39 39 129 129 39 129 129 39 39 39 39 39 39 39 129 129 39 129 129 39 39 39 39 39 129 129 39 129 129 39 39 129 129 129 129 129 129 129 129 39
39 129 129 39 39 129 129 39 39 39 39 129 129 129 129 129 129 129 129 39 129 129 129 129 129 129 39 129 129 129 129 129 129 39 129 129 129 129 129 129 129 129 39
39 129 129 39 39 129 129 39 39 129 129 129 129 129 129 129 129 129 129 39 129 129 129 129 129 129 39 129 129 129 129 129 129 39 39 39 39 129 129 39 129 129 39
39 129 129 129 129 129 129 129 129 129 129 129 129 129 129 39 39 39 39 39 129 129 39 39 129 129 39 39 39 39 39 129 129 39 129 129 39 129 129 39 129 129 39
39 129 129 129 129 129 129 129 129 129 39 39 39 129 129 39 39 39 39 39 129 129 39 39 39 39 39 39 39 39 39 129 129 39 129 129 39 39 39 39 129 129 39
39 39 39 39 39 39 39 39 39 129 39 39 129 129 129 39 39 129 129 129 129 129 129 129 39 129 129 129 129 129 39 39 39 39 129 129 129 129 129 129 129 129 39
39 39 39 39 39 39 39 39 39 129 129 39 129 129 129 39 39 129 129 129 129 129 129 129 39 129 129 39 129 129 129 129 129 39 129 129 129 129 129 129 129 129 39
39 39 39 129 129 129 129 129 39 129 129 39 39 39 39 39 39 129 129 39 39 39 129 129 39 129 129 39 129 129 129 129 129 39 129 129 39 39 39 39 39 39 39
39 129 129 129 129 129 129 129 39 129 129 39 39 129 129 39 39 129 129 39 129 129 129 129 39 129 129 39 129 129 39 129 129 39 129 129 39 39 39 39 39 39 39
39 129 129 129 129 39 39 39 39 129 129 39 39 129 129 39 39 129 129 39 129 129 129 129 39 129 129 39 129 129 39 129 129 39 129 129 129 129 129 129 129 39 39
39 39 39 129 129 39 39 39 39 39 39 39 39 129 129 39 39 129 129 39 39 39 129 129 39 129 129 39 129 129 39 129 129 39 129 129 129 129 129 129 129 39 39
39 129 129 129 129 129 129 129 129 129 129 129 129 129 129 129 129 129 129 129 129 39 129 129 39 39 39 39 129 129 39 129 129 39 129 129 39 39 39 129 129 129 39
39 129 129 129 129 129 129 39 129 129 129 129 129 129 129 129 129 129 129 129 129 39 129 129 129 129 129 129 129 129 39 129 129 39 129 129 39 39 39 129 129 129 39
39 129 129 39 39 129 129 39 129 129 39 39 39 39 39 39 129 129 39 129 129 39 129 129 129 129 129 129 129 129 39 129 129 39 39 39 39 39 39 129 129 39 39
39 129 129 39 129 129 129 39 129 129 129 129 129 39 129 129 129 129 39 129 129 39 129 129 39 39 129 129 39 39 39 129 129 129 129 129 129 129 129 129 129 39 39
39 129 129 39 129 129 129 39 129 129 129 129 129 39 129 129 129 129 39 129 129 39 129 129 39 39 129 129 39 39 39 129 129 129 129 129 129 129 129 129 129 39 39
39 129 129 39 39 39 39 39 39 39 39 39 39 39 39 39 39 39 39 39 39 39 39 39 39 39 39 39 39 39 39 39 39 39 39 39 39 39 39 39 39 39 39
