181 39 39 39 181 181 39 39 39 181 39 39 39 39 39 39 181 39 39 39 39 39 39 39 39 39 39 181 39 39 39 39 39 39 39 39 39 39 39 39 39 39 181
181 39 39 39 181 181 39 39 39 181 39 39 39 39 39 39 181 39 39 39 39 39 39 39 39 39 39 181 39 39 39 39 39 39 39 39 39 39 39 39 39 39 181
181 39 39 39 39 39 39 39 39 181 39 39 39 39 39 39 181 39 39 39 39 39 39 39 39 39 39 181 39 39 39 181 181 39 39 181 181 181 181 39 39 39 181
181 181 181 39 39 39 39 181 181 181 181 181 39 39 181 181 181 181 181 181 181 181 181 181 181 39 39 181 181 39 39 181 181 181 181 181 39 39 181 181 39 39 181
181 181 181 39 39 181 181 39 39 39 181 181 39 39 39 39 39 39 39 39 39 39 39 39 181 39 39 181 181 39 39 181 181 39 39 39 39 39 39 39 39 39 181
181 181 181 39 39 181 181 39 39 39 181 181 39 39 39 39 39 39 39 39 39 39 39 39 181 39 39 39 181 39 39 39 181 39 39 39 39 39 39 39 39 39 181
181 39 39 39 39 39 181 39 39 39 181 181 39 39 181 181 181 181 181 181 181 181 39 39 181 39 39 39 181 39 39 39 181 39 39 181 181 181 181 181 181 181 181
181 39 39 39 39 39 181 181 39 39 181 39 39 39 181 39 39 39 39 39 39 181 39 39 181 181 39 39 181 181 181 181 181 39 39 39 39 39 39 39 39 39 181
181 39 39 181 39 39 181 181 39 39 181 39 39 39 39 39 39 39 39 39 39 181 39 39 39 181 39 39 39 39 39 39 181 39 39 39 39 39 39 39 39 39 181
181 39 39 181 39 39 39 39 39 39 181 39 39 39 39 39 181 181 181 181 181 181 39 39 39 181 39 39 39 39 39 39 181 181 39 39 39 181 181 181 39 39 181
181 39 39 181 39 39 39 39 39 39 181 181 39 39 181 181 181 39 39 39 39 39 39 39 39 181 181 181 181 181 39 39 39 181 39 39 39 181 181 181 39 39 181
181 39 39 181 39 39 39 181 181 181 181 181 39 39 181 181 181 39 39 39 39 39 39 39 39 39 39 39 39 181 39 39 39 181 181 181 181 181 181 181 39 39 181
181 181 181 181 181 39 39 181 39 39 39 39 39 39 39 39 181 39 39 181 181 181 181 39 39 39 39 39 39 181 39 39 39 181 39 39 39 39 39 39 39 39 181
181 39 39 181 39 39 39 181 39 39 39 39 39 39 39 39 181 39 39 181 39 39 39 39 39 39 181 39 39 181 39 39 181 181 39 39 39 39 39 39 39 39 181
181 39 39 181 39 39 39 181 39 39 181 181 39 39 39 39 181 39 39 181 39 39 39 39 39 39 181 39 39 181 39 39 181 181 39 39 181 181 181 181 181 181 181
181 39 39 181 181 39 39 181 39 39 181 181 181 181 181 181 181 39 39 181 39 39 181 181 181 181 181 39 39 181 39 39 181 181 39 39 39 39 39 39 39 39 181
181 39 39 181 181 39 39 181 181 181 181 39 39 39 39 39 39 39 39 181 39 39 39 39 39 39 181 39 39 39 39 39 39 181 39 39 39 39 39 39 39 39 181
181 39 39 181 181 39 39 181 181 39 39 39 39 39 39 39 39 39 39 181 39 39 39 39 39 39 181 39 39 39 39 39 39 181 181 181 181 39 39 181 39 39 181
181 39 39 39 39 39 39 39 39 39 39 39 39 39 39 181 181 181 181 181 39 39 181 181 39 39 181 181 181 181 181 39 39 181 39 39 181 39 39 181 39 39 181
181 39 39 39 39 39 39 39 39 39 181 181 181 39 39 181 181 181 181 181 39 39 181 181 181 181 181 181 181 181 181 39 39 181 39 39 181 181 181 181 39 39 181
181 181 181 181 181 181 181 181 181 39 181 181 39 39 39 181 181 39 39 39 39 39 39 39 181 39 39 39 39 39 181 181 181 181 39 39 39 39 39 39 39 39 181
181 181 181 181 181 181 181 181 181 39 39 181 39 39 39 181 181 39 39 39 39 39 39 39 181 39 39 39 39 39 39 39 39 181 39 39 39 39 39 39 39 39 181
181 181 181 39 39 39 39 39 181 39 39 181 181 181 181 181 181 39 39 181 181 181 39 39 181 39 39 181 39 39 39 39 39 181 39 39 181 181 181 181 181 181 181
181 39 39 39 39 39 39 39 181 39 39 181 181 39 39 181 181 39 39 181 39 39 39 39 181 39 39 181 39 39 181 39 39 181 39 39 181 181 181 181 181 181 181
181 39 39 39 39 181 181 181 181 39 39 181 181 39 39 181 181 39 39 181 39 39 39 39 181 39 39 181 39 39 181 39 39 181 39 39 39 39 39 39 39 181 181
181 181 181 39 39 181 181 181 181 181 181 181 181 39 39 181 181 39 39 181 181 181 39 39 181 39 39 181 39 39 181 39 39 181 39 39 39 39 39 39 39 181 181
181 39 39 39 39 39 39 39 39 39 39 39 39 39 39 39 39 39 39 39 39 181 39 39 181 181 181 181 39 39 181 39 39 181 39 39 181 181 181 39 39 39 181
181 39 39 39 39 39 39 39 39 39 39 39 39 39 39 39 39 39 39 39 39 181 39 39 39 39 39 39 39 39 181 39 39 181 39 39 181 181 181 39 39 39 181
181 39 39 181 181 39 39 181 39 39 181 181 181 181 181 181 39 39 181 39 39 181 39 39 39 39 39 39 39 39 181 39 39 181 181 181 181 181 181 39 39 181 181
181 39 39 181 39 39 39 181 39 39 39 39 39 181 39 39 39 39 181 39 39 181 39 39 181 181 39 39 181 181 181 39 39 39 39 39 39 39 39 39 39 181 181
181 39 39 181 39 39 39 181 39 39 39 39 39 181 39 39 39 39 181 39 39 181 39 39 181 181 39 39 181 181 181 39 39 39 39 39 39 39 39 39 39 181 181
181 39 39 181 181 181 181 181 181 181 181 181 181 181 181 181 181 181 181 181 181 181 181 181 181 181 181 181 181 181 181 181 181 181 181 181 181 181 181 181 181 181 181
181 39 39 181 39 39 39 39 39 39 39 39 39 39 39 39 39 39 39 39 39 39 39 39 39 39 39 39 39 39 39 39 39 39 39 39 39 39 39 39 39 39 39
