291 291 291 291 291 291 291 291 291 291 291 291 291 291 291 291 291 291 291 291 291 291 291 291 291
63 63 63 39 39 39 39 39 39 39 39 39 39 39 39 39 39 39 39 39 39 39 39 39 13
89 89 89 63 39 13 39 39 39 39 39 39 39 39 39 39 39 39 39 39 39 39 39 63 63
89 89 89 89 63 63 39 39 39 39 39 39 39 39 39 39 39 39 39 39 63 63 63 89 89
89 89 89 89 89 89 39 39 39 35 39 39 39 35 39 39 39 39 39 39 89 89 89 89 89
89 89 89 89 89 89 63 63 39 39 39 39 39 63 63 39 39 39 13 63 89 89 89 89 89
89 89 89 89 89 89 89 89 63 63 39 39 39 89 89 63 63 63 63 89 89 89 89 89 89
89 89 89 89 89 89 89 89 89 89 39 39 39 89 89 89 89 89 89 89 89 89 89 89 89
89 89 89 89 89 89 89 89 89 13 39 39 39 89 89 89 89 89 89 89 89 89 89 89 89
89 89 89 89 89 89 89 89 39 39 39 39 39 39 89 89 89 89 89 89 89 89 89 89 89
89 89 89 89 89 89 89 89 39 39 39 39 39 39 39 89 89 89 89 89 89 89 89 89 89
89 89 89 89 89 89 89 89 63 35 39 39 39 35 39 13 89 89 89 89 89 89 89 89 89
89 89 89 89 89 89 89 89 89 39 39 39 39 39 39 63 89 89 89 89 89 89 89 89 89
89 89 89 89 89 89 89 89 89 63 39 39 39 39 63 89 89 89 89 89 89 89 89 89 89
89 89 89 89 89 89 89 89 89 89 39 39 39 63 89 89 89 89 89 89 89 89 89 89 89
89 89 89 89 89 89 89 89 89 89 39 39 39 89 89 89 89 89 89 89 89 89 89 89 89
89 89 89 89 89 89 89 89 89 89 39 39 39 89 89 89 89 89 89 89 89 89 89 89 89
89 89 89 89 89 89 89 89 89 39 39 39 39 39 39 89 89 89 89 89 89 89 89 89 89
89 89 89 89 89 89 89 89 39 39 39 39 39 39 39 13 89 89 89 89 89 89 89 89 89
89 89 89 89 89 89 89 89 39 35 39 39 39 35 39 63 89 89 89 89 89 89 89 89 89
89 89 89 89 89 89 89 89 39 39 39 39 39 39 63 89 89 89 89 89 89 89 89 89 89
89 89 89 89 89 89 89 89 63 63 39 39 39 63 89 89 89 89 89 89 89 89 89 89 89
89 89 89 89 89 89 89 89 89 89 39 39 39 89 89 89 89 89 89 89 89 89 89 89 89
89 89 89 89 89 89 89 89 89 89 39 39 39 89 89 89 89 89 89 89 89 89 89 89 89
89 89 89 89 89 89 89 89 13 35 39 39 39 35 39 39 39 89 89 89 89 89 89 89 89
89 89 89 89 89 39 39 39 39 39 39 39 39 39 39 39 39 39 13 89 89 89 89 89 89
291 291 291 291 291 39 39 39 39 39 39 39 39 39 39 39 39 39 39 291 291 291 291 291 291