129 129 129 129 129 129 129 129 129 129 129 129 129 129 129 129 129 129 129 129 129 129 129 129 129
39 39 39 129 129 129 129 129 129 129 129 129 129 129 129 261 262 263 129 129 129 129 129 129 129
39 39 39 39 129 129 129 129 129 129 129 129 129 129 129 286 288 289 129 129 129 129 129 39 39
39 39 39 39 39 39 129 129 129 129 129 129 129 129 129 312 314 315 129 129 39 39 39 39 39
39 39 39 39 39 39 129 129 129 129 129 129 129 129 129 129 129 129 129 129 39 39 39 39 39
39 39 39 39 39 39 39 39 129 129 79 80 81 39 39 129 129 129 129 39 39 39 39 39 39
39 39 39 39 39 39 39 39 39 39 79 80 81 39 39 39 39 39 39 39 39 39 39 39 39
39 39 39 39 39 39 39 39 39 39 79 80 81 39 39 39 39 39 39 39 39 39 39 39 39
39 39 39 39 39 39 39 39 39 129 79 80 81 39 39 39 39 39 39 39 39 39 39 39 39
39 39 39 39 39 39 39 39 129 129 129 129 129 129 39 39 39 39 39 39 39 39 39 39 39
39 39 39 39 39 39 39 39 129 129 129 129 129 129 129 39 39 39 39 39 39 39 39 39 39
39 39 39 39 39 39 39 39 39 129 129 129 129 129 129 129 39 39 39 39 39 39 39 39 39
39 39 39 39 39 39 39 39 39 129 129 129 129 129 129 39 39 39 39 39 39 39 39 39 39
39 39 39 39 39 39 39 39 39 39 79 80 81 129 39 39 39 39 39 39 39 39 39 39 39
39 39 39 39 39 39 39 39 39 39 79 80 81 39 39 39 39 39 39 39 39 39 39 39 39
39 39 39 39 39 39 39 39 39 39 79 80 81 39 39 39 39 39 39 39 39 39 39 39 39
39 39 39 39 39 39 39 39 39 39 79 80 81 39 39 39 39 39 39 39 39 39 39 39 39
39 39 39 39 39 39 39 39 39 129 129 129 129 129 129 39 39 39 39 39 39 39 39 39 39
39 39 39 39 39 39 39 39 129 129 129 129 129 129 129 129 39 39 39 39 39 39 39 39 39
39 39 39 39 39 39 39 39 129 129 129 129 129 129 129 39 39 39 39 39 39 39 39 39 39
39 39 39 39 39 39 39 39 129 129 129 129 129 129 39 39 39 39 39 39 39 39 39 39 39
39 39 39 39 39 39 39 39 39 39 79 80 81 39 39 39 39 39 39 39 39 39 39 39 39
39 39 39 39 39 39 39 39 39 39 79 80 81 39 39 39 39 39 39 39 39 39 39 39 39
39 39 39 39 39 39 39 39 39 39 79 80 81 39 39 39 39 39 39 39 39 39 39 39 39
39 39 39 39 39 39 39 39 129 129 129 129 129 129 129 129 129 39 39 39 39 39 39 39 39
39 39 39 39 39 129 129 129 129 129 129 129 129 129 129 129 129 129 129 39 39 39 39 39 39
