27 26 27 26 27 26 27 26 27 26 27 26 27 26 27 26 27 26 27 26 27 26 27 26 27 26 27 26 27 26 27 26 27 26 27 26 27 26 27 26 27
26 27 26 27 26 27 26 27 26 27 26 27 26 27 26 27 26 27 26 27 26 27 26 27 26 27 26 27 26 27 26 27 26 27 26 27 26 27 26 27 26
27 38 19 19 19 19 19 19 19 19 19 19 19 19 19 19 19 19 19 19 19 19 19 19 19 19 19 19 19 19 19 19 19 19 19 19 19 19 19 38 26
26 27 60 61 61 61 61 61 61 61 61 61 61 61 61 61 61 61 61 61 61 61 61 61 61 61 61 61 61 61 61 61 61 61 61 61 61 61 62 26 27
27 38 85 86 86 86 86 86 86 86 86 86 86 86 86 86 86 86 86 86 86 86 86 86 86 86 86 86 86 86 86 86 86 86 86 86 86 86 87 38 26
26 27 85 86 86 86 86 86 86 86 86 86 86 86 86 86 86 86 86 86 86 86 86 86 86 86 86 86 86 86 86 86 86 86 86 86 86 86 87 26 27
27 38 85 86 86 86 86 86 86 86 86 86 86 86 86 86 86 86 86 86 86 86 86 86 86 86 86 86 86 86 86 86 86 86 86 86 86 86 87 38 26
26 27 85 86 86 86 86 38 38 38 38 38 38 38 38 38 38 38 38 38 38 38 38 38 38 38 38 38 38 38 38 38 38 38 86 86 86 86 87 26 27
27 38 85 86 86 86 86 38 175 54 40 40 40 40 40 40 40 40 40 40 40 40 40 40 40 40 40 40 40 40 40 40 177 38 86 86 86 86 87 38 26
26 27 85 86 86 86 86 38 225 79 38 38 38 38 38 38 38 38 38 38 38 38 38 38 38 38 38 38 38 38 38 81 227 38 86 86 86 86 87 26 27
27 38 85 86 86 86 86 38 38 40 38 38 38 38 38 38 38 38 38 38 38 38 38 38 38 38 38 38 38 38 38 40 38 38 86 86 86 86 87 38 26
26 27 85 86 86 86 86 38 38 40 38 38 38 38 38 38 38 38 38 38 38 38 38 38 38 38 38 38 38 38 38 40 38 38 86 86 86 86 87 26 27
27 38 85 86 86 86 86 38 38 40 38 38 38 38 38 38 38 38 38 38 38 38 38 38 38 38 38 38 38 38 38 40 38 38 86 86 86 86 87 38 26
26 27 85 86 86 86 86 38 38 40 38 38 38 38 38 38 38 38 38 38 38 38 38 38 38 38 38 38 38 38 38 40 38 38 86 86 86 86 87 26 27
27 38 85 86 86 86 86 38 38 39 38 38 38 38 38 38 38 38 38 38 38 38 38 38 38 38 38 38 38 38 38 39 38 38 86 86 86 86 87 38 26
26 27 85 86 86 86 86 38 38 39 38 38 38 38 38 38 38 38 38 38 38 38 38 38 38 38 38 38 38 38 38 39 38 38 86 86 86 86 87 26 27
27 38 85 86 86 86 86 38 38 39 38 38 38 38 38 38 38 38 38 38 38 38 38 38 38 38 38 38 38 38 38 39 38 38 86 86 86 86 87 38 26
26 27 85 86 86 86 86 38 38 40 38 38 38 38 38 38 38 38 38 38 38 38 38 38 38 38 38 38 38 38 38 40 38 38 86 86 86 86 87 26 27
27 38 85 86 86 86 86 38 38 40 38 38 38 38 38 38 38 38 38 38 38 38 38 38 38 38 38 38 38 38 38 40 38 38 86 86 86 86 87 38 26
26 27 85 86 86 86 86 38 38 40 38 38 38 38 38 38 38 38 38 38 38 38 38 38 38 38 38 38 38 38 38 40 38 38 86 86 86 86 87 26 27
27 38 85 86 86 86 86 38 38 40 38 38 38 38 38 38 38 38 38 38 38 38 38 38 38 38 38 38 38 38 38 40 38 38 86 86 86 86 87 38 26
26 27 85 86 86 86 86 38 38 40 38 38 38 38 38 38 38 38 38 38 38 38 38 38 38 38 38 38 38 38 38 40 38 38 86 86 86 86 87 26 27
27 38 85 86 86 86 86 38 38 40 38 38 38 38 38 38 38 38 38 38 38 38 38 38 38 38 38 38 38 38 38 40 38 38 86 86 86 86 87 38 26
26 27 85 86 86 86 86 38 38 40 38 38 38 38 38 38 38 38 38 38 38 38 38 38 38 38 38 38 38 38 38 40 38 38 86 86 86 86 87 26 27
27 38 85 86 86 86 86 38 38 40 38 38 38 38 38 38 38 38 38 38 38 38 38 38 38 38 38 38 38 38 38 40 38 38 86 86 86 86 87 38 26
26 27 85 86 86 86 86 38 39 39 38 38 38 38 16 16 16 38 38 38 38 38 38 38 16 16 16 38 38 38 38 40 38 38 86 86 86 86 87 26 27
27 38 85 86 86 86 86 38 176 177 39 229 229 39 16 16 16 38 39 38 39 38 38 38 16 16 16 39 229 229 39 176 177 38 86 86 86 86 87 38 26
26 27 85 86 86 86 86 38 226 227 38 38 38 38 41 41 41 38 39 38 7 38 39 38 41 41 41 38 38 38 38 226 227 38 86 86 86 86 87 26 27
27 38 85 86 86 86 86 86 38 38 38 38 38 38 38 38 38 39 39 39 32 39 39 39 38 38 38 38 38 38 38 38 38 86 86 86 86 86 87 38 26
26 27 85 86 86 86 86 86 86 86 86 38 38 38 38 38 38 38 38 38 38 38 38 38 38 38 38 38 38 38 86 86 86 86 86 86 86 86 87 26 27
27 38 85 86 86 86 86 86 86 86 86 86 38 38 38 38 38 38 38 38 38 38 38 38 38 38 38 38 38 86 86 86 86 86 86 86 86 86 87 38 26
26 27 85 86 86 86 86 86 86 86 86 86 86 86 86 86 86 86 86 38 38 38 86 86 86 86 86 86 86 86 86 86 86 86 86 86 86 86 87 26 27
27 38 85 86 86 86 86 86 86 86 86 86 86 86 86 86 86 86 86 38 38 38 86 86 86 86 86 86 86 86 86 86 86 86 86 86 86 86 87 38 26
26 27 85 86 86 86 86 86 86 86 86 86 86 86 86 86 86 86 86 38 38 38 86 86 86 86 86 86 86 86 86 86 86 86 86 86 86 86 87 26 27
27 38 85 86 86 86 86 86 86 86 86 86 86 86 86 86 86 86 86 38 38 38 86 86 86 86 86 86 86 86 86 86 86 86 86 86 86 86 87 38 26
26 27 85 86 86 86 86 86 86 86 86 86 86 86 86 86 86 86 86 38 38 38 86 86 86 86 86 86 86 86 86 86 86 86 86 86 86 86 87 26 27
26 27 26 27 26 27 26 27 26 27 26 27 26 27 26 27 26 27 38 38 38 38 38 26 27 26 27 26 27 26 27 26 27 26 27 26 27 26 27 26 27
27 26 27 26 27 26 27 26 27 26 27 26 27 26 27 26 27 26 27 38 38 38 26 27 26 27 26 27 26 27 26 27 26 27 26 27 26 27 26 27 26
