16 16 16 16 16 16 16 16 16 16 16 16 16 16 16 16 16 16 16 16 16 16 16 16 16 16 16 16 16 16 16 16 16 16 16 16 16 16 16 16 16
16 16 16 16 16 16 16 16 16 16 16 16 16 16 16 16 16 16 16 16 16 16 16 16 16 16 16 16 16 16 16 16 16 16 16 16 16 16 16 16 16
16 16 38 38 38 38 38 38 38 38 38 38 38 38 38 38 38 38 38 38 38 38 38 38 38 38 38 38 38 38 38 38 38 38 38 38 38 38 38 16 16
16 16 38 38 38 38 38 38 38 38 38 38 38 38 38 38 38 38 38 38 38 38 38 38 38 38 38 38 38 38 38 38 38 38 38 38 38 38 38 16 16
16 16 38 38 38 38 38 38 38 38 38 38 38 38 38 38 38 38 38 38 38 38 38 38 38 38 38 38 38 38 38 38 38 38 38 38 38 38 38 16 16
16 16 38 38 38 38 38 38 38 38 38 38 38 38 38 38 38 38 38 38 38 38 38 38 38 38 38 38 38 38 38 38 38 38 38 38 38 38 38 16 16
16 16 38 38 38 38 38 38 38 38 38 38 38 38 38 38 38 38 38 38 38 38 38 38 38 38 38 38 38 38 38 38 38 38 38 38 38 38 38 16 16
16 16 38 38 38 38 38 57 58 58 58 58 58 58 58 58 58 58 58 58 58 58 58 58 58 58 58 58 58 58 58 58 58 59 38 38 38 38 38 16 16
16 16 38 38 38 38 38 82 83 83 83 83 83 83 83 83 83 83 83 83 83 83 83 83 83 83 83 83 83 83 83 83 83 84 38 38 38 38 38 16 16
16 16 38 38 38 38 38 82 83 83 83 83 83 83 83 83 83 83 83 83 83 83 83 83 83 83 83 83 83 83 83 83 83 84 38 38 38 38 38 16 16
16 16 38 38 38 38 38 82 83 83 83 83 83 83 83 83 83 83 83 83 83 83 83 83 83 83 83 83 83 83 83 83 83 84 38 38 38 38 38 16 16
16 16 38 38 38 38 38 82 83 83 83 83 83 83 83 83 83 83 83 83 83 83 83 83 83 83 83 83 83 83 83 83 83 84 38 38 38 38 38 16 16
16 16 38 38 38 38 38 82 83 83 83 83 83 83 83 83 83 83 83 83 83 83 83 83 83 83 83 83 83 83 83 83 83 84 38 38 38 38 38 16 16
16 16 38 38 38 38 38 82 83 83 83 83 83 83 83 83 83 83 83 83 83 83 83 83 83 83 83 83 83 83 83 83 83 84 38 38 38 38 38 16 16
16 16 38 38 38 38 38 82 83 83 83 83 83 83 83 83 83 83 83 83 83 83 83 83 83 83 83 83 83 83 83 83 83 84 38 38 38 38 38 16 16
16 16 38 38 38 38 38 82 83 83 83 83 83 83 83 83 83 83 83 83 83 83 83 83 83 83 83 83 83 83 83 83 83 84 38 38 38 38 38 16 16
16 16 38 38 38 38 38 82 83 83 83 83 83 83 83 83 83 83 83 83 83 83 83 83 83 83 83 83 83 83 83 83 83 84 38 38 38 38 38 16 16
16 16 38 38 38 38 38 82 83 83 83 83 83 83 83 83 83 83 83 83 83 83 83 83 83 83 83 83 83 83 83 83 83 84 38 38 38 38 38 16 16
16 16 38 38 38 38 38 82 83 83 83 83 83 83 83 83 83 83 83 83 83 83 83 83 83 83 83 83 83 83 83 83 83 84 38 38 38 38 38 16 16
16 16 38 38 38 38 38 82 83 83 83 83 83 83 83 83 83 83 83 83 83 83 83 83 83 83 83 83 83 83 83 83 83 84 38 38 38 38 38 16 16
16 16 38 38 38 38 38 82 83 83 83 83 83 83 83 83 83 83 83 83 83 83 83 83 83 83 83 83 83 83 83 83 83 84 38 38 38 38 38 16 16
16 16 38 38 38 38 38 82 83 83 83 83 83 83 83 83 83 83 83 83 83 83 83 83 83 83 83 83 83 83 83 83 83 84 38 38 38 38 38 16 16
16 16 38 38 38 38 38 82 83 83 83 83 83 83 83 83 83 83 83 83 83 83 83 83 83 83 83 83 83 83 83 83 83 84 38 38 38 38 38 16 16
16 16 38 38 38 38 38 82 83 83 83 83 83 83 83 83 83 83 83 83 83 83 83 83 83 83 83 83 83 83 83 83 83 84 38 38 38 38 38 16 16
16 16 38 38 38 38 38 82 83 83 83 83 83 83 83 83 83 83 83 83 83 83 83 83 83 83 83 83 83 83 83 83 83 84 38 38 38 38 38 16 16
16 16 38 38 38 38 38 82 83 83 83 83 83 83 83 83 83 83 83 83 83 83 83 83 83 83 83 83 83 83 83 83 83 84 38 38 38 38 38 16 16
16 16 38 38 38 38 38 82 83 83 83 83 83 83 83 83 83 83 83 83 83 83 83 83 83 83 83 83 83 83 83 83 83 84 38 38 38 38 38 16 16
16 16 38 38 38 38 38 107 83 83 83 83 83 83 83 83 83 83 83 83 83 83 83 83 83 83 83 83 83 83 83 83 83 109 38 38 38 38 38 16 16
16 16 38 38 38 38 38 38 107 108 108 83 83 83 83 83 83 83 83 83 83 83 83 83 83 83 83 83 83 83 108 108 109 38 38 38 38 38 38 16 16
16 16 38 38 38 38 38 38 38 38 38 107 83 83 83 83 83 83 83 83 83 83 83 83 83 83 83 83 83 109 38 38 38 38 38 38 38 38 38 16 16
16 16 38 38 38 38 38 38 38 38 38 38 107 108 108 108 108 108 108 83 83 83 108 108 108 108 108 108 109 38 38 38 38 38 38 38 38 38 38 16 16
16 16 38 38 38 38 38 38 38 38 38 38 38 38 38 38 38 38 38 76 77 78 38 38 38 38 38 38 38 38 38 38 38 38 38 38 38 38 38 16 16
16 16 38 38 38 38 38 38 38 38 38 38 38 38 38 38 38 38 38 76 77 78 38 38 38 38 38 38 38 38 38 38 38 38 38 38 38 38 38 16 16
16 16 38 38 38 38 38 38 38 38 38 38 38 38 38 38 38 38 38 76 77 78 38 38 38 38 38 38 38 38 38 38 38 38 38 38 38 38 38 16 16
16 16 38 38 38 38 38 38 38 38 38 38 38 38 38 38 38 38 38 76 77 78 38 38 38 38 38 38 38 38 38 38 38 38 38 38 38 38 38 16 16
16 16 38 38 38 38 38 38 38 38 38 38 38 38 38 38 38 38 38 76 77 78 38 38 38 38 38 38 38 38 38 38 38 38 38 38 38 38 38 16 16
16 16 16 16 16 16 16 16 16 16 16 16 16 16 16 16 16 16 16 63 64 65 16 16 16 16 16 16 16 16 16 16 16 16 16 16 16 16 16 16 16
16 16 16 16 16 16 16 16 16 16 16 16 16 16 16 16 16 16 16 88 89 90 16 16 16 16 16 16 16 16 16 16 16 16 16 16 16 16 16 16 16
