1 2 1 2 1 2 1 2 1 2 1 2 1 2 1 2 1 2 1 2 1 2 1 2 1 2 1 2 1 2 1 2 1 2 1 2 1 2 1 2 1
2 38 38 38 38 38 38 38 38 38 38 38 38 38 38 38 38 38 38 38 38 38 38 38 38 38 38 38 38 38 38 38 38 38 38 38 38 38 38 38 38
1 2 38 38 38 38 38 38 128 129 38 38 38 38 38 38 38 38 38 38 38 38 38 38 38 38 38 38 38 38 38 128 129 38 38 38 38 38 38 1 2
2 38 38 38 38 38 38 38 153 154 38 38 38 38 38 126 127 38 38 38 38 38 38 38 126 127 38 38 38 38 38 153 154 38 38 38 38 38 38 38 1
1 2 38 38 38 38 38 38 178 179 38 38 126 127 38 151 152 55 55 55 55 55 55 55 151 152 38 126 127 38 38 178 179 38 38 38 38 38 38 1 2
2 38 38 38 38 38 38 38 176 177 56 40 151 152 40 176 177 80 80 80 80 80 80 80 176 177 40 151 152 40 54 176 177 38 38 38 38 38 38 38 1
1 2 38 38 38 38 38 38 176 104 106 39 176 177 39 176 79 80 80 80 80 80 80 80 81 177 39 176 177 39 104 106 177 38 38 38 38 38 38 1 2
2 38 38 38 38 38 38 38 176 40 39 63 201 202 64 226 79 80 80 80 80 80 80 80 81 227 89 201 202 89 39 40 177 38 38 38 38 38 38 38 1
1 2 38 38 38 38 38 38 176 40 63 83 226 227 83 83 79 80 80 80 80 80 80 80 81 89 89 226 227 89 90 40 177 38 38 38 38 38 38 1 2
2 38 38 38 38 38 38 38 176 40 88 83 83 83 83 83 79 80 80 80 80 80 80 80 81 89 89 89 89 89 90 40 177 38 38 38 38 38 38 38 1
1 2 38 38 38 38 38 38 226 40 88 83 83 83 83 83 79 80 80 80 80 80 80 80 81 89 89 89 89 89 90 40 227 38 38 38 38 38 38 1 2
2 38 38 38 38 38 38 38 38 40 88 83 83 83 83 126 127 80 80 80 80 80 80 80 126 127 89 89 89 89 90 40 38 38 38 38 38 38 38 38 1
1 2 38 38 38 38 38 38 38 40 40 40 40 83 83 151 152 105 105 105 105 105 105 105 151 152 89 89 40 40 40 40 38 38 38 38 38 38 38 1 2
2 38 38 38 38 38 38 38 38 39 39 39 40 88 83 176 177 39 203 39 203 39 203 39 176 177 89 90 40 39 39 39 38 38 38 38 38 38 38 38 1
1 2 38 38 38 38 38 38 38 39 204 39 40 88 83 176 177 39 228 39 228 39 228 39 176 177 89 90 40 39 204 39 38 38 38 38 38 38 38 1 2
2 38 38 38 38 38 38 38 38 39 229 39 40 88 89 226 227 64 64 64 64 64 64 64 226 227 89 90 40 39 229 39 38 38 38 38 38 38 38 38 1
1 2 38 38 38 38 38 38 38 39 204 39 40 88 89 89 89 89 89 89 89 89 89 89 89 89 89 90 40 39 204 39 38 38 38 38 38 38 38 1 2
2 38 38 38 38 38 38 38 38 40 40 40 40 88 89 89 89 89 89 89 89 89 89 89 89 89 89 90 40 40 40 40 38 38 38 38 38 38 38 38 1
1 2 38 38 38 38 38 38 38 40 63 64 64 89 89 89 89 89 89 89 89 89 89 89 89 89 89 89 64 64 65 40 38 38 38 38 38 38 38 1 2
2 38 38 38 38 38 38 38 128 129 88 89 89 40 40 40 40 40 40 40 40 40 40 40 40 40 40 40 89 89 90 128 129 38 38 38 38 38 38 38 1
1 2 38 38 38 38 38 38 153 154 88 89 17 40 39 39 39 39 39 39 39 39 39 39 39 39 39 40 89 89 90 153 154 38 38 38 38 38 38 1 2
2 38 38 38 38 38 38 38 178 179 40 40 40 40 39 204 39 39 204 39 7 39 204 39 39 204 39 40 40 40 40 178 179 38 38 38 38 38 38 38 1
1 2 38 38 38 38 38 38 201 202 39 39 39 39 39 229 39 40 229 39 32 39 229 40 39 229 39 39 39 39 39 201 202 38 38 38 38 38 38 1 2
2 38 38 38 38 38 38 38 176 177 39 204 204 39 39 204 39 40 64 64 64 64 64 40 39 204 39 39 204 204 39 176 177 38 38 38 38 38 38 38 1
1 2 38 38 38 38 38 38 201 202 39 229 229 39 39 229 39 40 89 89 89 89 89 40 39 229 39 39 229 229 39 201 202 38 38 38 38 38 38 1 2
2 38 38 38 38 38 38 38 176 177 39 204 204 39 12 12 12 40 40 40 40 40 40 40 12 12 12 39 204 204 39 176 177 38 38 38 38 38 38 38 1
1 2 38 38 38 38 38 38 201 202 38 38 38 38 37 38 38 39 11 39 39 39 10 39 38 38 38 38 38 38 38 201 202 38 38 38 38 38 38 1 2
2 38 38 38 38 38 38 38 38 38 38 38 38 38 38 38 38 39 36 39 7 39 35 39 38 38 38 38 38 38 38 38 38 38 38 38 38 38 38 38 1
1 2 38 38 38 38 38 38 38 38 38 38 38 38 38 38 38 38 38 38 38 38 38 38 38 38 38 38 38 38 38 38 38 38 38 38 38 38 38 1 2
2 38 38 38 38 38 38 38 38 38 38 38 38 38 38 38 38 38 38 38 38 38 38 38 38 38 38 38 38 38 38 38 38 38 38 38 38 38 38 38 1
1 2 38 38 38 38 38 38 38 38 38 38 38 38 38 38 38 38 38 38 38 38 38 38 38 38 38 38 38 38 38 38 38 38 38 38 38 38 38 1 2
2 38 38 38 38 38 38 38 38 38 38 38 38 38 38 38 38 38 38 38 38 38 38 38 38 38 38 38 38 38 38 38 38 38 38 38 38 38 38 38 1
1 2 38 38 38 38 38 38 38 38 38 38 38 38 38 38 38 38 38 38 38 38 38 38 38 38 38 38 38 38 38 38 38 38 38 38 38 38 38 1 2
2 38 38 38 38 38 38 38 38 38 38 38 38 38 38 38 38 38 38 38 38 38 38 38 38 38 38 38 38 38 38 38 38 38 38 38 38 38 38 38 1
1 2 38 38 38 38 38 38 38 38 38 38 38 38 38 38 38 38 38 38 38 38 38 38 38 38 38 38 38 38 38 38 38 38 38 38 38 38 38 1 2
1 2 1 2 1 2 1 2 1 2 1 2 1 2 1 2 1 2 38 38 38 38 38 1 2 1 2 1 2 1 2 1 2 1 2 1 2 1 2 1 2
2 1 2 1 2 1 2 1 2 1 2 1 2 1 2 1 2 1 2 38 38 38 1 2 1 2 1 2 1 2 1 2 1 2 1 2 1 2 1 2 1
