80 80 80 80 80 80 80 80 80 80 80 80 80 80 80 80 80 80 80 80 80 80 80 80 80
80 80 80 80 80 80 80 38 38 38 38 38 38 38 38 38 38 38 38 38 38 38 80 80 80
80 80 80 80 38 38 165 38 38 38 38 38 38 38 38 38 38 38 38 38 38 38 80 80 80
80 80 80 38 38 38 38 38 38 38 38 38 38 38 38 38 38 38 38 38 38 38 165 38 38
80 80 38 38 38 38 38 38 38 38 38 38 38 38 38 38 38 38 38 38 38 38 38 38 38
80 80 38 38 38 38 38 38 38 38 38 38 38 38 38 38 38 38 38 40 38 38 38 38 38
165 80 38 38 38 38 38 38 67 38 38 7 7 7 38 38 38 38 38 38 38 38 38 38 38
165 38 165 38 66 38 66 66 68 38 89 32 32 32 89 38 66 67 165 67 68 165 38 38 165
38 38 38 38 66 165 67 92 93 63 89 89 89 89 65 165 91 92 165 92 93 165 38 38 165
38 38 38 66 92 165 92 92 93 113 114 114 89 89 115 165 91 92 165 92 93 165 165 38 165
38 38 38 91 92 165 92 92 118 165 165 165 88 90 165 66 92 92 165 92 93 165 165 38 165
38 38 38 91 92 165 92 118 165 165 165 63 89 90 165 116 117 92 165 92 118 165 66 38 165
165 38 165 91 92 165 118 165 165 63 64 89 89 89 65 165 165 91 165 93 165 165 91 38 165
165 38 91 92 118 165 165 165 63 89 89 89 89 89 115 165 165 91 165 118 165 66 92 38 165
165 38 116 118 165 165 165 92 113 89 89 89 89 89 64 65 165 116 165 165 165 91 38 165 165
165 38 165 165 165 165 165 92 165 113 114 89 89 89 89 115 165 165 165 165 165 116 38 165 165
68 165 38 165 165 165 165 165 165 165 165 88 89 89 115 165 165 165 165 165 165 165 38 165 66
68 165 38 165 165 165 165 165 165 165 165 113 114 115 165 165 165 165 165 165 165 165 38 165 91
68 165 38 165 165 165 165 165 165 165 72 72 73 74 74 165 165 165 165 165 165 38 165 165 91
68 165 165 38 165 66 67 67 68 165 97 97 98 99 124 165 165 165 165 165 66 38 165 165 91
68 165 165 38 165 116 92 92 92 68 72 98 98 99 165 165 165 165 165 165 91 38 66 67 92
92 68 165 38 165 165 116 117 117 118 97 98 98 124 165 165 165 66 67 38 38 165 91 92 92
92 68 165 165 38 38 165 165 165 165 97 98 99 165 165 66 67 92 38 165 165 165 91 92 92
92 68 165 165 165 165 38 38 165 165 122 98 99 165 165 91 38 38 165 66 67 67 92 92 92
92 92 67 67 68 165 165 165 38 165 165 97 99 165 66 92 38 165 165 91 92 92 92 92 92
92 92 92 92 92 67 68 165 165 38 38 97 99 165 91 92 38 165 165 91 92 92 92 92 92
92 92 92 92 92 92 92 67 67 68 38 97 99 165 116 38 165 165 165 91 92 92 92 92 92
92 92 92 92 92 92 92 92 92 93 38 97 99 165 38 165 66 67 67 92 92 92 92 92 92
92 92 92 92 92 92 92 92 92 93 38 97 99 38 165 66 92 92 92 92 92 92 92 92 92
92 92 92 92 92 92 92 92 92 93 38 97 99 165 165 91 92 92 92 92 92 92 92 92 92
