38 38 38 38 38 38 38 38 38 38 38 38 30 38 38 38 38 38 30 38 38 38 38 38 38
38 38 38 38 26 27 38 190 190 190 190 190 190 190 190 190 190 190 190 190 190 190 38 26 27
38 38 38 38 190 190 191 214 215 215 215 215 215 215 215 215 215 215 215 215 215 216 164 38 30
26 27 38 191 214 215 216 214 215 215 215 215 215 215 215 215 215 215 215 215 215 216 189 190 190
38 38 166 216 214 215 216 214 215 215 215 215 215 215 215 215 215 215 215 215 215 216 214 215 216
38 38 166 216 214 215 216 214 215 39 39 39 39 39 39 39 215 215 38 215 215 216 214 215 216
38 38 166 216 214 38 216 214 215 39 39 38 38 38 39 39 215 215 38 215 215 241 214 215 216
190 190 191 216 239 38 241 38 38 39 39 38 38 38 39 39 38 38 38 38 38 38 214 139 140
214 215 216 241 38 38 38 38 38 38 38 38 38 38 38 34 38 38 38 38 38 38 239 164 38
214 215 216 38 38 38 38 38 38 38 38 38 38 38 38 38 38 38 38 38 38 38 38 164 38
214 215 216 38 38 38 38 38 38 38 38 34 38 38 38 38 38 38 38 38 38 38 38 164 38
140 141 216 38 38 38 38 26 27 38 38 38 38 38 38 26 27 38 38 38 30 38 38 164 38
38 166 241 38 38 38 38 38 38 38 38 38 38 38 38 38 38 38 38 38 38 38 38 164 38
38 166 38 38 38 38 38 38 38 38 38 38 38 38 38 34 38 38 38 30 38 38 38 164 38
38 166 38 38 38 212 38 26 27 38 38 38 38 38 38 38 26 27 38 38 38 38 139 38 38
38 166 38 26 27 237 38 38 38 38 38 38 38 38 38 38 38 38 38 38 38 38 164 26 27
38 38 141 38 38 38 38 38 38 38 34 38 38 38 38 38 38 38 38 38 38 38 164 38 38
38 38 166 38 38 38 212 212 212 38 38 38 38 38 38 38 212 212 212 38 26 27 164 38 38
38 38 166 38 38 38 237 237 237 213 213 38 38 38 212 212 237 237 237 38 38 139 38 38 38
26 27 38 141 38 38 38 26 27 237 238 38 38 38 237 237 38 30 38 38 38 164 38 38 38
38 38 38 166 38 38 38 38 38 38 38 38 38 38 13 38 38 38 38 38 38 164 38 38 38
38 38 38 166 30 38 38 38 38 38 38 38 38 38 38 38 38 38 38 139 140 38 38 38 38
38 38 38 38 140 141 26 27 38 38 38 38 38 38 38 38 38 30 139 38 38 38 38 38 38
38 38 38 38 38 38 140 141 38 38 13 38 38 38 38 38 139 140 38 38 38 38 38 38 38
38 38 38 38 38 38 38 38 141 38 38 38 38 38 38 38 164 38 38 26 27 38 38 38 38
38 38 38 38 38 38 38 38 38 140 141 38 38 38 38 38 164 38 38 38 38 38 38 38 38
38 26 27 38 38 38 38 38 38 38 166 38 38 13 38 139 38 38 38 38 38 38 38 38 38
38 38 38 38 38 38 38 38 38 38 166 38 38 139 140 26 27 38 38 38 38 38 26 27 38
38 38 38 38 38 38 26 27 38 38 166 38 38 164 38 38 38 38 38 38 38 38 38 38 38
38 38 38 38 38 38 38 38 38 38 166 38 38 164 38 38 38 38 38 38 38 38 38 38 38
