38 38 13 38 1 2 38 38 38 38 38 38 38 38 38 38 38 38 38 38 38 13 38 1 2
38 38 38 38 38 38 38 38 38 38 13 38 38 38 38 38 38 38 38 38 38 38 38 38 5
1 2 38 38 38 38 38 38 38 38 38 38 38 38 38 38 38 38 38 38 38 38 38 38 38
38 38 38 38 38 38 38 38 38 38 38 38 38 38 38 38 38 38 38 38 38 38 38 38 38
38 38 38 38 38 38 38 38 38 14 14 14 14 14 14 14 38 38 38 38 38 38 38 38 38
38 38 38 38 38 38 38 38 38 38 38 38 38 38 38 38 38 38 40 38 38 38 38 38 38
38 38 38 38 38 40 38 38 38 38 38 38 38 38 38 38 38 38 40 38 38 38 38 38 38
38 38 38 38 38 40 38 38 38 38 38 38 38 38 38 9 38 38 40 38 38 38 38 38 38
38 38 38 38 38 40 38 38 38 38 38 38 38 38 38 38 38 38 40 38 38 38 38 38 38
38 38 38 38 38 40 38 38 38 38 38 9 38 38 38 38 38 38 40 38 38 38 38 38 38
38 38 38 38 38 40 38 1 2 38 38 38 38 38 38 1 2 38 40 38 5 38 38 38 38
38 38 38 38 38 40 38 38 38 38 38 38 38 38 38 38 38 38 40 38 38 38 38 38 38
38 38 38 38 38 40 38 38 38 38 38 38 38 38 38 9 38 38 40 5 38 38 38 38 38
38 38 38 38 38 40 40 1 2 38 38 38 38 38 38 38 1 2 40 38 38 38 38 38 38
38 38 38 1 2 38 40 38 38 38 38 38 38 38 38 38 38 38 40 38 38 38 38 1 2
38 38 38 38 38 38 40 38 38 38 9 38 38 38 38 38 38 38 40 38 38 38 38 38 38
38 38 38 38 38 38 40 40 40 40 38 38 38 38 38 40 40 40 40 38 1 2 38 38 38
38 38 38 38 38 38 38 38 38 40 40 38 38 38 40 40 38 38 38 38 38 38 38 38 38
1 2 166 38 38 38 38 1 2 38 11 38 38 38 11 38 38 5 38 38 38 38 38 38 38
38 38 38 38 38 38 38 38 38 38 36 38 38 38 36 38 38 38 38 38 38 38 38 38 38
38 38 38 38 5 38 38 38 38 38 38 38 38 38 38 38 38 38 38 38 38 38 38 38 38
38 38 38 13 38 38 1 2 38 38 38 38 38 38 38 38 38 5 38 38 38 38 38 38 38
38 38 38 38 38 38 38 38 38 38 38 38 38 38 38 38 38 38 38 38 38 38 38 13 38
38 38 38 38 38 165 38 38 38 38 38 38 38 38 38 38 38 38 38 1 2 38 38 38 38
38 38 38 38 38 38 38 38 38 38 38 38 38 38 38 38 38 38 38 38 38 38 38 38 38
38 1 2 38 38 38 38 38 38 38 38 38 38 38 38 38 38 38 38 38 38 38 38 38 38
38 38 38 38 13 38 38 38 38 38 38 38 38 38 38 1 2 38 38 38 38 38 1 2 38
38 38 38 38 38 38 1 2 38 38 38 38 38 38 38 38 38 38 38 13 38 38 38 38 38
38 38 38 38 38 38 38 38 38 38 38 38 38 38 38 38 38 38 38 38 38 38 38 38 38
38 38 38 38 38 38 38 38 38 38 38 38 38 38 38 38 38 38 38 38 38 38 38 38 38
