38 38 38 38 165 88 89 90 165 38 38 38 38 38 38 38 38 38 38 38 38 38 38 38 165 170 171 172 165 38 38 38 38 38 38 38
38 38 38 38 165 113 114 115 165 38 38 38 38 38 38 38 38 38 38 38 38 38 38 38 165 195 196 197 165 38 38 38 38 38 38 38
38 38 38 38 165 72 73 74 165 38 38 38 38 38 38 38 38 38 38 38 38 38 38 38 165 72 73 74 165 38 38 38 38 38 38 38
38 38 38 38 165 97 98 98 74 165 38 38 38 38 38 38 38 38 38 38 38 38 38 165 72 98 98 99 165 38 38 38 38 38 38 38
38 38 38 38 165 122 98 98 98 74 165 165 165 165 165 165 165 165 165 165 165 165 165 72 98 98 98 124 165 38 38 38 38 38 38 38
38 38 38 38 38 80 122 98 98 98 73 73 73 73 73 73 73 73 73 73 73 73 73 98 98 98 124 165 38 38 38 38 38 38 38 38
38 38 38 38 38 38 165 122 98 98 98 98 98 98 98 98 98 98 98 98 98 98 98 98 98 124 165 165 38 38 38 38 38 38 38 38
38 38 38 38 38 38 38 165 122 123 123 123 123 123 123 98 98 98 123 123 123 123 123 123 124 165 38 38 38 38 38 38 38 38 38 38
38 38 38 38 38 38 38 38 165 165 165 165 165 165 165 97 98 99 165 165 165 165 165 165 165 38 38 38 38 38 38 38 38 38 38 38
38 38 38 38 38 38 38 38 38 38 38 38 38 38 165 97 98 99 165 38 38 38 38 38 38 38 38 38 38 38 38 38 38 38 38 38
38 38 38 38 38 38 38 38 38 38 38 38 38 38 165 97 98 99 165 38 38 38 38 38 38 38 38 38 38 38 38 38 38 38 38 38
38 38 38 38 38 38 38 38 38 38 38 38 38 38 165 97 98 99 165 38 38 38 38 38 38 38 38 38 38 38 38 38 38 38 38 38
38 38 38 38 38 38 38 38 38 38 38 38 38 38 80 97 98 99 80 38 38 38 38 38 38 38 38 38 38 38 38 38 38 38 38 38
38 38 38 38 38 38 38 38 38 38 38 38 38 38 80 51 77 53 80 38 38 38 38 38 38 38 38 38 38 38 38 38 38 38 38 38
38 38 38 38 38 38 38 38 38 38 38 38 38 38 80 51 77 53 80 38 38 38 38 38 38 38 38 38 38 38 38 38 38 38 38 38
38 38 38 38 38 38 38 38 38 38 38 38 38 38 80 51 77 103 80 38 38 38 38 38 38 38 38 38 38 38 38 38 38 38 38 38
38 38 38 38 38 38 38 38 38 38 38 38 38 38 80 51 77 53 80 38 38 38 38 38 38 38 38 38 38 38 38 38 38 38 38 38
38 38 38 38 38 38 38 38 38 38 38 38 38 38 80 51 77 53 80 38 38 38 38 38 38 38 38 38 38 38 38 38 38 38 38 38
38 38 38 38 38 38 38 38 38 38 38 38 38 38 80 97 98 99 80 38 38 38 38 38 38 38 38 38 38 38 38 38 38 38 38 38
38 38 38 38 38 38 38 38 38 38 38 38 38 38 80 97 98 99 80 38 38 38 38 38 38 38 38 38 38 38 38 38 38 38 38 38
38 38 38 38 38 38 38 38 38 38 38 38 38 38 80 97 98 99 80 38 38 38 38 38 38 38 38 38 38 38 38 38 38 38 38 38
20 38 38 38 38 38 38 38 38 38 38 38 38 38 80 97 98 99 162 162 38 38 38 38 38 38 38 38 38 38 38 38 38 38 38 38
20 20 38 38 38 38 38 38 38 38 38 162 162 162 80 97 98 99 80 162 162 38 38 38 38 38 38 38 38 38 38 38 38 38 38 38
38 38 38 38 38 38 38 38 38 162 162 162 72 73 73 98 159 98 73 74 162 162 162 162 38 38 38 38 38 38 38 38 38 38 38 38
38 38 38 38 38 38 80 80 80 80 72 73 98 98 98 98 159 98 98 98 73 73 74 80 162 162 38 38 38 38 38 38 38 38 38 38
38 38 38 38 38 80 80 72 73 73 98 98 98 98 98 98 159 159 98 98 98 98 98 73 74 162 162 38 38 38 38 38 38 38 38 38
38 38 38 38 38 80 80 97 98 98 98 98 98 98 98 98 159 159 98 98 98 98 98 98 98 74 162 38 38 38 38 38 38 38 38 38
38 38 38 38 38 162 72 98 98 98 98 98 98 98 98 98 98 98 98 98 98 98 98 98 98 99 162 38 38 38 38 38 38 38 38 38
38 38 38 38 38 162 97 98 98 98 98 98 98 98 98 98 98 98 98 98 98 98 98 98 98 124 162 38 38 38 38 38 38 38 38 38
38 38 38 38 38 162 122 123 98 98 98 98 98 98 98 98 98 98 98 98 98 98 98 98 124 162 162 38 38 38 38 38 38 38 38 38
38 38 38 38 38 162 162 162 122 123 98 98 98 98 98 98 98 98 98 98 123 123 123 124 162 162 38 38 38 38 38 38 38 38 38 38
38 38 38 38 38 38 38 162 162 162 122 123 123 123 123 123 123 123 123 124 162 162 162 162 162 38 38 38 38 38 38 38 38 38 38 38
38 38 38 38 38 38 38 38 38 162 162 162 162 162 162 162 162 162 162 162 162 162 162 162 38 38 38 38 38 38 38 38 38 38 38 38
38 38 38 38 38 38 38 38 38 38 38 38 38 38 38 38 38 38 38 38 38 38 38 38 38 38 38 38 38 38 38 38 38 38 38 38
38 38 38 38 38 38 38 38 38 38 38 38 38 38 38 38 38 38 38 38 38 38 38 38 38 38 38 38 38 38 38 38 38 38 38 38
38 38 38 38 38 38 38 38 38 38 38 38 38 38 38 38 38 38 38 38 38 38 38 38 38 38 38 38 38 38 38 38 38 38 38 38
