69 70 70 71 38 38 38 38 38 69 70 70 70 70 70 70 70 70 70 70 70 70 70 71 38 38 38 38 38 69 70 70 70 70 70 71
94 95 95 96 38 38 38 38 38 94 95 95 95 95 95 95 95 95 95 95 95 95 95 96 38 38 38 38 38 94 95 95 95 95 95 96
94 95 95 96 38 38 38 38 38 119 95 95 95 95 95 95 95 95 95 95 95 95 95 121 38 38 38 38 38 94 95 95 95 95 95 96
94 95 95 96 38 38 38 38 38 38 119 120 120 120 120 120 120 120 120 120 120 120 121 38 38 38 38 38 38 94 95 95 95 95 95 96
94 95 95 96 12 38 38 38 38 38 13 38 38 38 38 38 38 38 38 38 38 38 12 38 38 38 38 38 12 94 95 95 95 95 95 96
94 95 95 95 71 38 38 38 38 38 38 38 38 38 38 38 38 38 38 38 38 38 38 38 38 38 38 38 69 95 95 95 95 95 95 96
94 95 95 95 95 71 30 38 38 38 38 38 38 38 38 38 38 38 38 38 38 38 38 38 38 38 38 30 94 95 95 95 95 95 95 96
94 95 95 95 95 95 71 38 38 38 38 38 38 38 38 38 38 38 38 38 38 38 38 38 38 38 69 70 95 95 95 95 95 95 95 96
94 95 95 95 95 95 95 71 13 26 27 30 12 38 34 38 38 38 34 38 26 27 30 38 13 69 95 95 95 95 95 95 95 95 95 96
94 95 95 95 95 95 95 95 70 70 70 70 70 71 38 38 38 38 38 69 70 70 70 70 70 95 95 95 95 95 95 95 120 120 120 121
94 95 95 95 95 95 95 95 95 95 95 95 95 96 38 38 38 38 38 94 95 95 95 95 95 95 95 95 95 120 120 121 20 20 20 20
94 95 95 95 95 95 95 95 95 95 95 95 95 96 38 38 38 38 30 94 95 95 95 95 95 120 120 120 121 20 20 20 20 20 20 20
94 95 95 95 95 95 95 95 95 95 95 95 95 96 38 38 38 38 38 94 95 120 120 120 121 20 20 20 20 20 20 20 20 20 20 20
94 95 95 95 95 95 95 95 95 95 120 120 120 121 34 38 38 38 34 119 121 20 20 20 20 20 20 20 20 20 20 20 20 69 70 71
94 95 95 95 95 95 95 95 120 121 20 20 20 20 20 38 38 38 20 20 20 20 20 20 20 20 20 20 20 20 20 69 70 95 95 96
94 95 95 95 95 120 120 121 20 20 20 20 20 20 20 38 38 38 20 20 20 20 20 20 20 20 20 20 20 69 70 95 95 95 95 96
94 95 120 120 121 20 20 20 20 20 20 20 20 20 20 38 38 38 20 20 20 20 20 20 20 20 69 70 70 95 95 95 95 95 95 96
119 121 20 20 20 20 20 20 20 20 20 20 20 20 38 38 38 38 38 69 70 70 70 70 70 70 95 95 95 95 95 95 95 95 95 96
20 20 20 20 20 20 20 20 20 69 70 70 70 71 34 38 38 38 34 94 95 95 95 95 95 95 95 95 95 95 95 95 95 95 95 96
20 20 20 20 20 20 20 69 70 95 95 95 95 96 38 38 38 38 12 94 95 95 95 95 95 95 95 95 95 95 95 95 95 95 95 96
20 20 20 20 20 69 70 95 95 95 95 95 95 96 38 38 38 38 38 119 95 95 95 95 95 95 95 95 95 95 95 95 95 95 95 96
20 20 20 69 70 95 95 95 95 95 95 120 120 121 38 38 38 38 38 38 119 95 95 95 95 95 95 95 95 95 95 95 95 95 95 96
20 20 69 95 95 95 95 95 95 120 121 12 38 38 38 38 38 38 38 38 38 119 120 120 95 95 95 95 95 95 95 95 95 95 95 96
69 70 95 95 95 95 120 120 121 13 38 38 38 38 34 38 38 38 34 38 38 38 38 12 119 120 95 95 95 95 95 95 95 95 95 96
94 95 95 95 95 96 38 38 38 38 38 38 38 38 38 38 38 38 38 38 30 38 38 38 38 38 119 95 95 95 95 95 95 95 95 96
94 95 95 95 95 121 38 38 30 38 38 26 27 38 38 38 38 38 38 38 38 38 38 38 38 38 12 94 95 95 95 95 95 95 95 96
94 95 95 95 96 38 38 38 38 9 38 38 38 38 38 38 38 38 38 38 38 38 38 9 38 38 38 94 95 95 95 95 95 95 95 96
94 95 95 95 96 30 38 38 38 34 38 38 38 8 38 38 38 38 38 38 38 30 38 34 38 38 38 94 95 95 95 95 95 95 95 96
94 95 95 95 96 38 38 38 38 38 38 38 38 38 38 38 38 38 38 38 38 38 38 38 38 38 38 94 95 95 95 95 95 95 95 96
94 95 95 95 96 38 38 38 38 38 30 38 38 38 38 38 38 38 26 27 38 38 38 38 38 38 38 94 95 95 95 95 95 95 95 96
94 95 95 95 96 38 38 13 38 38 38 38 38 38 38 38 38 38 38 38 38 38 38 38 38 38 69 95 95 95 95 95 95 95 95 96
94 95 95 95 95 70 71 38 26 27 38 38 38 30 26 27 38 38 38 38 12 26 27 13 38 69 95 95 95 95 95 95 95 95 95 96
94 95 95 95 95 95 95 70 71 12 38 38 38 38 38 38 38 38 38 38 38 38 38 38 69 95 95 95 95 95 95 95 95 95 95 96
94 95 95 95 95 95 95 95 95 70 70 70 70 70 70 70 70 70 70 70 70 70 70 70 95 95 95 95 95 95 95 95 95 95 95 96
38 38 38 38 38 38 38 38 38 38 38 38 38 38 38 38 38 38 38 38 38 38 38 38 38 38 38 38 38 38 38 38 38 38 38 38
38 38 38 38 38 38 38 38 38 38 38 38 38 38 38 38 38 38 38 38 38 38 38 38 38 38 38 38 38 38 38 38 38 38 38 38
